111111111111111111111111
1001C0000000000000000001
100100000100000010001C01
100100000010000010100001
100100000001000010000001
100100000000100000000001
100000000000010000000C01
1000000C0000001000000001
100000000000000100000001
1001000000E0000000000001
100100000000000001000101
1001000C0000000000101001
10010000000P000000010001
100000000000000000001001
111111111111111111111111
