11111
1E0P1
10001
100C1
11111


