11111
1P001
10N01
1E0C1
11111

