11111111111111111111111111111
1P000000000C00000000000000E01
10000000000000C00000C00000001
11111111111111111111111111111
