111111111111111111111111
1E0000000000000C000P0111
101001010010000010100101
1010010010101010001C0101
10000000000000000N000111
111111111111111111111111
