11111
1E0P1
10001
1N0C1
11111


